#####################
#...................#
#######.....####....#
#.....#....#....#...#
#.#########....Y.#..#
#.......X...........#
#####################
kraj